{
    "台": "臺",
    "裏": "裡",
    "啓": "啟",
    "着": "著",
    "够": "夠",
    "麽": "麼",
    "妳": "你",
    "祂": "他",
    "綫": "線",
    "温": "溫",
    "葱": "蔥",
    "幷": "並",
    "峯": "峰",
    "强": "強",
    "牀": "床",
    "靑": "青",
    "眞": "真",
    "烟": "煙",
    "污": "汙",
    "濕": "溼",
    "癡": "痴",
    "秘": "祕",
    "羣": "群",
    "衆": "眾",
    "庄": "莊",
    "〇": "零",
    "蕃": "番",
    "崐": "崑",
    "擡": "抬",
    "敍": "敘",
    "曬": "晒",
    "赢": "贏",
    "揾": "搵",
    "烮": "烈",
    "喞": "唧",
    "刴": "剁",
    "鍫": "鍬",
    "路": "路",
    "料": "料",
    "林": "林",
    "鬡": "鬞",
    "蒵": "溪",
    "臓": "臟",
    "𦤦": "餀",
    "劵": "券",
    "𱱿": "󿕅",
    "紥": "紮",
    "來": "來",
    "兀": "兀",
    "嗀": "嗀",
    "": "𫠛",
    "": "𫣆",
    "": "𫟧",
    "": "㾽",
    "": "𫝘",
    "": "󿕅",
    "": "𬠖",
    "": "䗁",
    "": "䌈",
    "": "䟘",
    "": "㓾",
    "": "𪐞",
    "": "𫠄",
    "": "吔",
    "𢽲": "㪐",
    "靓": "靚",
    "帘": "簾",
    "抛": "拋",
    "爲": "為",
    "戆": "憨",
    "冲": "沖",
    "羡": "羨",
    "秃": "禿",
    "炖": "燉",
    "嬷": "嬤",
    "怂": "慫",
    "篱": "籬",
    "绽": "綻",
    "捝": "挩",
    "叹": "嘆",
    "条": "條",
    "哟": "喲",
    "没": "沒",
    "担": "擔",
    "内": "內",
    "厘": "釐",
    "战": "戰",
    "来": "來",
    "嫺": "嫻",
    "恒": "恆",
    "横": "橫",
    "奥": "奧",
    "毁": "毀",
    "嘘": "噓",
    "踊": "踴",
    "熏": "薰",
    "万": "萬",
    "双": "雙",
    "吨": "噸",
    "莼": "蓴",
    "顺": "順",
    "躏": "躪",
    "悦": "悅",
    "杠": "槓",
    "丰": "豐",
    "凭": "憑",
    "与": "與",
    "韵": "韻",
    "给": "給",
    "涌": "湧",
    "咏": "詠",
    "黄": "黃",
    "沄": "澐",
    "虫": "蟲",
    "藴": "蘊",
    "芦": "蘆",
    "娱": "娛",
    "凉": "涼",
    "脚": "腳",
    "争": "爭",
    "禀": "稟",
    "祢": "你",
    "唇": "脣",
    "倆": "兩",
    "您": "你"
}